6 6
S W W W W W
0 0 0 0 0 0
W 0 W 0 W 0
W 0 W 0 W 0
0 0 0 W 0 E
W W 0 0 0 W